Апездал - Дилитант.
Апездошенная - Удивлённая.
Блядь - Девушка лёгкого поведения.
Блядство - Беспредел,неразбериха.
Выебон - Хвастовство,показуха.
Выебать - Совершить половой акт.
Вхуюжить - Воткнуть.
Гомосек - Голубой.
Долбоёб - Дурак.
Ебло - Лицо.
Еблище - Тоже что и ебло.
Ебать - Совершать половой акт.
Ебическая сила - Невероятная,сверхестественная сила,немыслемое явление.
Ебунок - Ребёнок.
Еблан - Дурак.
Ёбнуть - Ударить.
Ёболызнуть - Стукнуть.
Ебош - Груповой секс.
Заебал - Надоел,достал.
Заебатый - Хороший,отличный.
Злаебучий - Нехороший,плохой.
Заёб - Заскок,сдвиг по фазе.
Иди на хуй - Отстанть, свободен.
Колдоебина - Большая вещь, препятствие.
Манда - Женские половые органы.
Мандовошка - Малолетка.
Мокрощелка - Девушка легкого поведения.
Наебка - Обман.
Наебал - Обманул.
Наебаловка - Хитрость, уловка.
Напиздеть - Соврать, обмануть.
Отъебись - Отстань.
Охуеть - Удивиться.
Отхуевертить - Избить.
Опизденеть - Обнаглеть.
Охуевший - Обнаглевший.
Отебукать - Поколатить.
Пизда - Женские половые органы.
Пидарас - Голубой.
Пиздатый - Хороший.
Пиздец - Конец, смерть.
Пизданутый - Дурной.
Поебать - Наплевать.
Поебустика - Рутина.
Проебать - Потерять.
Подзалупный - Опущенный.
Пизденыш - Незначительный человек.
Припиздак - Дуралей.
Разъебать - Разбить.
Распиздяй - Развязанный человек, делающий все спустя рукава.
Разъебанный - разбитый.
Сука - Нехорошая женщина.
Сучка - Уменьшительно-ласкательное от "суки".
Трахать - Совершать половой акт.
Уебок - Отморозок.
Уебать - Ударить.
Угондошить - Избить, убить, уничтожить.
Уебан - То же что и "уебок".
Хитровыебанный - Скользкий человек.
Хуй - Мужской половой орган, личность мужского пола.
Хуйня - Некий предмет, очень плохое.
Хуета - Заморочка.
Хуево - Плохо.
Хуесос - Сосущий мужской член.
Хуеть - удивляться, балдеть.
Хуевертить - Бить, избивать.
Хуеглот - Глотающий мужской член.
Хуистика - Наука про....
Членосос - То же что и "хуесос".
Членоплет - Балбес.
Шлюха - Проститутка.